@@@@@@@@@@@@@@@@@@@@@@@@@@@@@@@@@@@@@@@
@@@@@@@@@@@@@@@@@@@@@@@@@@@@@@@@@@@@@@@
@@@@@@@@@@@@@@@@@@@@@@@@@@@@@@@@@@@@@@@
@@@@·······························@@@@
@@@@··················°············@@@@
@@@@·······························@@@@
@@@@···········00°···········|·····@@@@
@@@@···········00···°········|·····@@@@
@@@@····°······00············|·····@@@@
@@@@···········00············|·····@@@@
@@@@···········00············|·····@@@@
@@@@·······00000000··········|·····@@@@
@@@@·························|·····@@@@
@@@@·························|·····@@@@ 
@@@@··················°······|·····@@@@
@@@@···°°°°··················|·····@@@@
@@@@··············°··········|·····@@@@
@@@@@@@@@@@@@@@@@@@@@@@@@@@@@@@@@@@@@@@
@@@@@@@@@@@@@@@@@@@@@@@@@@@@@@@@@@@@@@@
@@@@@@@@@@@@@@@@@@@@@@@@@@@@@@@@@@@@@@@